111112211111
1          3
1      21  3
1      21  3
1121       2
1          2
2     1211 3
2     1211 3
11    1    3
11    1    3
1          3
112121212111